W W W W W W W W W W W W W W W W W W W W W
W B B B B B B B B B B B W B B B B B B W W
W B B B B B B B B B B B B B B B B B B B W
W B B B B B B B B B B B B B B B B B B B W
W W W W W L B B B B B B B B B B W W W W W
W W W W W W W W W L B B W B B B B B B B W
W B B B B B W W W W W W W B B B B B B B W
W B B B B B B B B B B B B B B B B B B B W
W B B B B B B B B B B B B B B B B B B B W
W B B B B W W W W L B B B B B B B R W W W
W B B B B B B B B B W W W W W W W W W W W
W B B B B B B B B B B B W W W W W W W W W
W W W W W W W W W L B B B B B B B B B B W
W W W W W W W W W W W W B B B B B B B B W
W E B B B B B B B B B B B B B B B B B B W
W W W W W W W W W W W W W W W W W W W W W
