W W W W W W W W W W W W W W W W W W W W W
W W W B B B W W W B B W B B B B B B B W W
W W B B B B B B B B B W B B B B B B B B W
W W B B B B B B B B B B B B B B B B B B W
W W B B B B B B B B B B B B B B B B E W W
W W B B B B B B B B B B B B B B W W W W W
W W B B B B B B B B B B B B B B B B B B W
W B B B B R W W W W W W W L B B B B B B W
W B B B W W W W W W W W W W W B B B B B W
W B B B B B B B B W W W B B B B B B B B W
W B B B B B B B B B W W B B B B B B B B W
W W W W B B B B B B W W B B B B W W W W W
W B B B B B B B B B W W B B B B B B B B W
W B B B B B B R W W W W W W L B B B B B W
W B B B R W W W W W W W W W W W W L B B W
W W W W W W W W W W W W W W W W W W W W W
